xxxxxxxx
x. p   x
x  o   x
x  b  .x
x  i .xx
x.xx c x
x.x .. x
xxxxxxxx

