xxxxxxx
x.    x
x  o  x
x  b  x
x  p.xx
x xx  x
x x i.x
xxxxxxx
