xxxxxxx
x.   ox  
x xxx x
x x x x
x   .xx
x xx  x
x x  .x
xxxxxxx
