xxxxxxx
x.    x
x  o  x
x  b   x
x   .xx
x xx  x
x x  .x
xxxxxxx
