xxxxxxxx
x.  p  x
x      x
xo    .x
xb   .xx
xixx c x
xxx .. x
xxxxxxxx

