xxxxxxxx
x. p   x
x  o   x
x  b  .x
x  i .xx
x.xx   x
x.x .. x
xxxxxxxx
