xxxxxxxx
x. p  .x
x.    .x
x.    .x
x. o ..x
x. b  .x
x..i...x
xxxxxxxx
